{
  "a": ["á", "ä", "å"],
  "e": ["é"],
  "i": ["í"],
  "o": ["ó"],
  "u": ["ú"],
  "y": ["ý"],
  "ö": ["ø"],
  "w": ["q"],
  "z": ["c"]
}
